.................
.................
.................
.................
.......OO........
..OO..OO.O.....OO
..OO...O.O.....OO
.........O.......
...........O.....
.................
...........O.....
.........O.......
..OO...O.O.....OO
..OO..OO.O.....OO
.......OO........

